##########
#        #
#  O     #
#        #
#    .   #
#  O . P #
#        #
#        #
#        #
##########